ctf_map1.txt

Author: Donut the Vikingchap
http://steamcommunity.com/id/donutvikingchap

A basic Capture the Flag map.

[SPAWN_RED] 1
[SPAWN_BLU] 2
[MEDKIT] 3
[AMMOPACK] 4
[FLAG_RED] 5
[FLAG_BLU] 6
[SPAWNVIS_RED] 7
[SPAWNVIS_BLU] 8
[RESUPPLY] 9

[DATA]
####################################################################################################################################################################
#                                          #####                                                       |#################+----------------+#########################
#                                      ### #####                                                       |#################|                |#########################
#                     #                ### #####                                                       |#################|   2  2  2  2   |#########################
#                     #                ### #####        ##########################                     |#################|                |#########################
#                     #                ### #####                     #############                     |#################|   2  2  2  2   |#########################
#               4 3   #                ###                           #############                     |#################|                |#########################
#                     #                #########        ########     #############                     +-----------------+   2  2  2  2   |#########################
#######################                #########        ########     #############                                       8               9|##########              #
#                                      #                ########                                                         8                |########     ######     #
#                                      #  3             ########                                        ##########       8                |######            #     #
#                                      #                ########     #############                      ##########       +-------+   +----+####           6  #     #
#                                      #  4             ########     #############                      ##########       ########|   |#######                #     #
#                                      #                ########     #############                       #########       ########+888+#####                        #
#                                      #                ########     ## MANN CO.##                        ########                                                 #
#                                      #                             #############                      #  #######                                                 #
#                                      #                             #############                      ##  ######                                                 #
#                                      #########        ##########################                      ###  #####                                                 #
#                                                                                                       ####  ####                       /TTT\                     #
#                                                                                                                                    /TTTTTTTT\                    #
#             ########                                                                                                          /#######\TTTTTT\                   #
#             ########                                                                  ########                               /#TTTTTTT#\TTTTTT\                  #
#             ########                                                                  ########                              /#TTTTTTTTT#\TTTTTT\                 #
########      ########                                                                        ##                             /#TTTTTTTTTTT#\TTTTT|                 #
########      ########                                                                     3  ##                            /#T[RED BREAD]T#\TTT#|                M#
########777777########                                                                        ##                           /#TTTTTTTTTTTTTTT#\TT#|               MM#
##}              9 {##                                                                        ##                           |#################|#T#|              MM #
##}   1  1  1  1   {##                                 /TTTTTTTTTTTT\                         ##############               |#TTTTTTTTTTTTTTT#|#T#              MM  #
##}                {##                                /##############\                                                     |#       TTTTTTTT#|#T              MM   #
##}   1  1  1  1   {##                               /################\                                                    |#  4 3  TTTTTTTT#|#              MM    #
##}                {##           ########           /##################\                                                   |#       TTTTTTTT#|              MM   ~ #
##}   1  1  1  1   {##           ########           [##################]                                                                                   MM      #
##}                {##           ########           [##################]                                                                                  MM  ~    #
######################           ########           [##################]                                                                                 MM     ~  #
######################           ########           [##################]                                                                                MM   ~     #
######################           ########vvvvvvvvvvv[##################]                                                                               MM         ~#
#                                ########           [##################]                                                                              MM    ~      #
#                                ########                                                                                                            MM  ~     ~   #
#                                ########                                                                                                           MM             #
#                                ########                                      #################                                                   MM      ~       #
#                                     ###                                      #                                                                  MM  ~          ~ #
#                                     ###                                      #   3   4                                                         MM     ~          #
#                                     ###                                      #                                                                MM          ~      #
#     #                                 >                                      #                                                               MM  ~     ~      ~  #
#     #  5                              >                                      #                                                              MM      ~            #
#     #                                 >                                      >                                                             MM             ~  ~   #
#     ######                          ###                                      >                              ############                  MM     ~      ~        #
#                                     ###                                      >                              ############                 MM   ~       ~      ~   #
#                                     ###                                      >                              ############                MM                       #
####################################################################################################################################################################
[END_DATA]
