ctf_turbine.txt

Author: Zahndar
http://steamcommunity.com/id/leafslayer

A remake of ctf_turbine from Team Fortress 2.

[SPAWN_RED] 1
[SPAWN_BLU] 2
[MEDKIT] 3
[FLAG_RED] 5
[FLAG_BLU] 6
[SPAWNVIS_RED] 7
[SPAWNVIS_BLU] 8
[RESUPPLY] 9

[DATA]
##################################################################################################################
#~~~~~~~~~~~~~~~~~~~~~~~~~~~~~~~~~~~~~~~~~~~~~~~~~~~~~~~~~~~~~#                 9                        #~~~~~~~#
#~~~~~~~~~~~~~~~~~~~~~~~~~~~~~~~~~~~~~~~~~~~~~~~~~~~~~~~~~~~~~#     1  1  1                              #~~~~~~~#
#~~~~~~~~~~~~~~~~~~~~~~~~~~~~~~~~~~~~~~~~~~~~~~~~~~~~~~~~~~~~~#                                          #~~~~~~~#
#~~~~~~~~~~~~~~~~~~~~~~~~~~~~~~~~~~~~~~~~~~~~~~~~~~~~~~~~~~~~~#     1  1  1                              #~~~~~~~#
############################################~~~~~~~~~~~~~~~~~~#                                          #~~~~~~~#
#                                          #~~~~~~~~~~~~~~~~~~#                                          #~~~~~~~#
#                                          ########################77777777777###############            #~~~~~~~#
#                                                                                           #            #~~~~~~~#
#                                                                                           #            #~~~~~~~#
#                                                                                           #           9#~~~~~~~#
#                                                                                           #            #~~~~~~~#
#     5                     <              ##################################               #            #~~~~~~~#
#                           <              #~~~~~~~~~~~~~~~~~~~~~~~~~~~~~~~~#               #            #~~~~~~~#
#                          ##              #~~~~~~~~~~~~~~~~~~~~~~~~~~~~~~~~#               #    1   1   #~~~~~~~#
#                    ^^^^^^##              ######################~~~~~~~~~~~#               7            #~~~~~~~#
#                                          <                    #~~~~~~~~~~~#               7    1   1   #~~~~~~~#
#                                          <                    #~~~~~~~~~~~#               7            #~~~~~~~#
#                                          ###################  #~~~~~~~~~~~#               7    1   1   #~~~~~~~#
#########        ############        #######~~~~~~~~~~~~~~~~~#  #~~~~~~~~~~~#               #            #~~~~~~~#
#~~~~~#            #~~~~~~#            #~~~~~~~~~~~~~~~~~~~~~#  #~~~~~~~~~~~#               ##############~~~~~~~#
#######            #~~~~~~#            #~~~~~~~~~~~~~~~~~~~~~#  #~~~~~~~~~~~#               #~~~~~~~~~~~~~~~~~~~~#
#                  ########            #~~~~~~~~~~~~~~~~~~~~~#  #~~~~~~~~~~~#               #~~~~~~~~~~~~~~~~~~~~#
#                                      #~~~~~~~~~~~~~~~~~~~~~#  #~~~~~~~~~~~#               #~~~~~~~~~~~~~~~~~~~~#
#                                      #~~~~~~~~~~~~~~~~~~~~~#  #~~~~~~~~~~~#               #######~~~~~~~~~~~~~~#
#                                      #~~~~~~~~~~~~~~~~~~~~~#  #~~~~~~~~~~~#                     #~~~~~~~~~~~~~~#
#                                      #~~~~~~~~~~~~~~~~~~~~~#  #~~~~~~~~~~~#                     #~~~~~~~~~~~~~~#
####  ###               ################~~~~~~~~~~~~~~~~~~~~~#  #~~~~~~~~~~~#                     #~~~~~~~~~~~~~~#
#       >               #~~~~~~~~~~~~#########################  #############                     #~~~~~~~~~~~~~~#
#       >               #~~~~~~~~~~~~#                                                         3  #~~~~~~~~~~~~~~#
#      ###              #~~~~~~~~~~~~#                                                            #~~~~~~~~~~~~~~#
#      ###              #~~~~~~~~~~~~#  #####################################                     #~~~~~~~~~~~~~~#
#   3   >               #~~~~~~~~~~~~#  #~~~~~~~~~~~~~~~~~~~~~~~~~~~~~~~~~~~#                     #~~~~~~~~~~~~~~#
#       >               ##############  #~~~~~~~~~~~~~~~~~~~~~~~~~~~~~~~~~~~#               #######~~~~~~~~~~~~~~#
#      ###                           #  #~~~~~~~~~~~~~~~~~~~~~~~~~~~~~~~~~~~#               #~~~~~~~~~~~~~~~~~~~~#
#      ###                           #  #~~~~~~~~~~~~~~~~~~~~~~~~~~~~~~~~~~~#               #~~~~~~~~~~~~~~~~~~~~#
#       >                            #  #~~~~~~~~~~~~~~~~~~~~~~~~~~~~~~~~~~~#               #~~~~~~~~~~~~~~~~~~~~#
#       >                            #  #~~~~~~~~~~~~~~~~~~~~~~~~~~~~~~~~~~~#               #~~~~~~~~~~~~~~~~~~~~#
#       >                            #  #~~~~~~~~~~~~~~~~~~~~~~~~~~~~~~~~~~~#               #~~~~~~~~~~~~~~~~~~~~#
#########################            #  #########################~~~~~~~~~~~#               #~~~~~~~~~~~~~~~~~~~~#
#~~~~~~~~~~~~~~~~~~~~~~~#            #                          #~~~~~~~~~~~#               #~~~~~~~~~~~~~~~~~~~~#
#~~~~~~~~~~~~~~~~~~~~~~~#            #                          #~~~~~~~~~~~#               #~~~~~~~~~~~~~~~~~~~~#
#~~~~~~~~~~~~~~~~~~~~######        ###########################  ################         ####~~~~~~~~~~~~~~~~~~~~#
#~~~~~~~~~~~~~~~~~~~~#                                                      #               #~~~~~~~~~~~~~~~~~~~~#
#~~~~~~~~~~~~~~~~~~~~#                                                      #               #~~~~~~~~~~~~~~~~~~~~#
#~~~~~~~~~~~~~~~~~~~~#                                 #            #       #               #~~~~~~~~~~~~~~~~~~~~#
#~~~~~~~~~~~~~~~~~~~~#    #        #vvvvvvvvvvvvvvvvvvv##############vvvvvvv####         ####~~~~~~~~~~~~~~~~~~~~#
#~~~~~~~~~~~~~~~~~~~~#    >                                                                 #####~~~~~~~~~~~~~~~~#
#~~~~~~~~~~~~~~~~~~~~#    >                                                                     #~~~~~~~~~~~~~~~~#
#~~~~~~~~~~~~~~~~~~~~#    >                                                                     #~~~~~~~~~~~~~~~~#
#~~~~~~~~~~~~~~~~~~~~#    >                                                                     #~~~~~~~~~~~~~~~~#
#~~~~~~~~~~~~~~~~~~~~#    >                                                                     #~~~~~~~~~~~~~~~~#
#~~~~~~~~~~~~~~~~~~~~#    >                                                                     #~~~~~~~~~~~~~~~~#
#~~~~~~~~~~~~~~~~~~~~#    >                                                                     #~~~~~~~~~~~~~~~~#
#~~~~~~~~~~~~~~~~~~~~#    >                                                                     #~~~~~~~~~~~~~~~~#
#~~~~~~~~~~~~~~~~~~~~#    >            ########                    ########                   3 #~~~~~~~~~~~~~~~~#
#~~~~~~~~~~~~~~~~~~~~#                 ########                    ########                     #~~~~~~~~~~~~~~~~#
#~~~~~~~~~~~~~~~~~~~~#                 ########         ##         ########                     #~~~~~~~~~~~~~~~~#
#~~~~~~~~~~~~~~~~~~~~#                 ########        #~~#        ########                     #~~~~~~~~~~~~~~~~#
#~~~~~~~~~~~~~~~~~~~~#                 ########         ##         ########                 #####~~~~~~~~~~~~~~~~#
#~~~~~~~~~~~~~~~~~~~~#                 ########                    ########                 #~~~~~~~~~~~~~~~~~~~~#
#~~~~~~~~~~~~~~~~#####                 ########         ##         ########                 #~~~~~~~~~~~~~~~~~~~~#
#~~~~~~~~~~~~~~~~#                     ########        #~~#        ########                 #~~~~~~~~~~~~~~~~~~~~#
#~~~~~~~~~~~~~~~~#                     ########         ##         ########                 #~~~~~~~~~~~~~~~~~~~~#
#~~~~~~~~~~~~~~~~#                     ########                    ########                 #~~~~~~~~~~~~~~~~~~~~#
#~~~~~~~~~~~~~~~~# 3                   ########                    ########            <    #~~~~~~~~~~~~~~~~~~~~#
#~~~~~~~~~~~~~~~~#                                                                     <    #~~~~~~~~~~~~~~~~~~~~#
#~~~~~~~~~~~~~~~~#                                                                     <    #~~~~~~~~~~~~~~~~~~~~#
#~~~~~~~~~~~~~~~~#                                                                     <    #~~~~~~~~~~~~~~~~~~~~#
#~~~~~~~~~~~~~~~~#                                                                     <    #~~~~~~~~~~~~~~~~~~~~#
#~~~~~~~~~~~~~~~~#                                                                     <    #~~~~~~~~~~~~~~~~~~~~#
#~~~~~~~~~~~~~~~~#                                                                     <    #~~~~~~~~~~~~~~~~~~~~#
#~~~~~~~~~~~~~~~~#                                                                     <    #~~~~~~~~~~~~~~~~~~~~#
#~~~~~~~~~~~~~~~~#####                                                                 <    #~~~~~~~~~~~~~~~~~~~~#
#~~~~~~~~~~~~~~~~~~~~####         ####^^^^^^^##############^^^^^^^^^^^^^^^^^###        #    #~~~~~~~~~~~~~~~~~~~~#
#~~~~~~~~~~~~~~~~~~~~#               #       #            #                                 #~~~~~~~~~~~~~~~~~~~~#
#~~~~~~~~~~~~~~~~~~~~#               #                                                      #~~~~~~~~~~~~~~~~~~~~#
#~~~~~~~~~~~~~~~~~~~~#               #                                                      #~~~~~~~~~~~~~~~~~~~~#
#~~~~~~~~~~~~~~~~~~~~####         ################  ###########################        ######~~~~~~~~~~~~~~~~~~~~#
#~~~~~~~~~~~~~~~~~~~~#               #~~~~~~~~~~~#                          #            #~~~~~~~~~~~~~~~~~~~~~~~#
#~~~~~~~~~~~~~~~~~~~~#               #~~~~~~~~~~~#                          #            #~~~~~~~~~~~~~~~~~~~~~~~#
#~~~~~~~~~~~~~~~~~~~~#               #~~~~~~~~~~~#########################  #            #########################
#~~~~~~~~~~~~~~~~~~~~#               #~~~~~~~~~~~~~~~~~~~~~~~~~~~~~~~~~~~#  #                            <       #
#~~~~~~~~~~~~~~~~~~~~#               #~~~~~~~~~~~~~~~~~~~~~~~~~~~~~~~~~~~#  #                            <       #
#~~~~~~~~~~~~~~~~~~~~#               #~~~~~~~~~~~~~~~~~~~~~~~~~~~~~~~~~~~#  #                            <       #
#~~~~~~~~~~~~~~~~~~~~#               #~~~~~~~~~~~~~~~~~~~~~~~~~~~~~~~~~~~#  #                           ###      #
#~~~~~~~~~~~~~~~~~~~~#               #~~~~~~~~~~~~~~~~~~~~~~~~~~~~~~~~~~~#  #                           ###      #
#~~~~~~~~~~~~~~#######               #~~~~~~~~~~~~~~~~~~~~~~~~~~~~~~~~~~~#  #############                <       #
#~~~~~~~~~~~~~~#                     #~~~~~~~~~~~~~~~~~~~~~~~~~~~~~~~~~~~#  #~~~~~~~~~~~#                <   3   #
#~~~~~~~~~~~~~~#                     #####################################  #~~~~~~~~~~~#               ###      #
#~~~~~~~~~~~~~~#                                                            #~~~~~~~~~~~#               ###      #
#~~~~~~~~~~~~~~#  3                                                         #~~~~~~~~~~~#                <       #
#~~~~~~~~~~~~~~#                     #############  #########################~~~~~~~~~~~#                <       #
#~~~~~~~~~~~~~~#                     #~~~~~~~~~~~#  #~~~~~~~~~~~~~~~~~~~~~###############                ###  ####
#~~~~~~~~~~~~~~#                     #~~~~~~~~~~~#  #~~~~~~~~~~~~~~~~~~~~~#                                      #
#~~~~~~~~~~~~~~#                     #~~~~~~~~~~~#  #~~~~~~~~~~~~~~~~~~~~~#                                      #
#~~~~~~~~~~~~~~#######               #~~~~~~~~~~~#  #~~~~~~~~~~~~~~~~~~~~~#                                      #
#~~~~~~~~~~~~~~~~~~~~#               #~~~~~~~~~~~#  #~~~~~~~~~~~~~~~~~~~~~#                                      #
#~~~~~~~~~~~~~~~~~~~~#               #~~~~~~~~~~~#  #~~~~~~~~~~~~~~~~~~~~~#            ########                  #
#~~~~~~~~~~~~~~~~~~~~#               #~~~~~~~~~~~#  #~~~~~~~~~~~~~~~~~~~~~#            #~~~~~~#            #######
#~~~~~~~##############               #~~~~~~~~~~~#  #~~~~~~~~~~~~~~~~~~~~~#            #~~~~~~#            #~~~~~#
#~~~~~~~#            #               #~~~~~~~~~~~#  #~~~~~~~~~~~~~~~~~#######        ############        #########
#~~~~~~~#   2   2    8               #~~~~~~~~~~~#  ###################                                          #
#~~~~~~~#            8               #~~~~~~~~~~~#                    >                                          #
#~~~~~~~#   2   2    8               #~~~~~~~~~~~#                    >                                          #
#~~~~~~~#            8               #~~~~~~~~~~~######################              ##vvvvvv                    #
#~~~~~~~#   2   2    #               #~~~~~~~~~~~~~~~~~~~~~~~~~~~~~~~~#              ##                          #
#~~~~~~~#            #               #~~~~~~~~~~~~~~~~~~~~~~~~~~~~~~~~#              >                           #
#~~~~~~~#            #               ##################################              >                     6     #
#~~~~~~~#            #                                                                                           #
#~~~~~~~#9           #                                                                                           #
#~~~~~~~#            #                                                                                           #
#~~~~~~~#            #                                                                                           #
#~~~~~~~#            ###############88888888888########################                                          #
#~~~~~~~#                                          #~~~~~~~~~~~~~~~~~~#                                          #
#~~~~~~~#                                          #~~~~~~~~~~~~~~~~~~############################################
#~~~~~~~#                              2  2  2     #~~~~~~~~~~~~~~~~~~~~~~~~~~~~~~~~~~~~~~~~~~~~~~~~~~~~~~~~~~~~~#
#~~~~~~~#                                          #~~~~~~~~~~~~~~~~~~~~~~~~~~~~~~~~~~~~~~~~~~~~~~~~~~~~~~~~~~~~~#
#~~~~~~~#                              2  2  2     #~~~~~~~~~~~~~~~~~~~~~~~~~~~~~~~~~~~~~~~~~~~~~~~~~~~~~~~~~~~~~#
#~~~~~~~#                        9                 #~~~~~~~~~~~~~~~~~~~~~~~~~~~~~~~~~~~~~~~~~~~~~~~~~~~~~~~~~~~~~#
##################################################################################################################
[END_DATA]
