ctf_zahn.txt

Author: Zahndar
http://steamcommunity.com/id/leafslayer

[SPAWN_RED] 1
[SPAWN_BLU] 2
[MEDKIT] 3
[FLAG_RED] 5
[FLAG_BLU] 6
[SPAWNVIS_RED] 7
[SPAWNVIS_BLU] 8
[RESUPPLY] 9

[DATA]
#!    /\!####==---___---==############################==CCo==######################################/\ \/\   \/  \/  \/   /\    / /\######################################==oCC==############################==---___---==####!\/    !#
#!\/\   !####II         II!                            ccOCo_                            <<       ##################################       >>                            _oCOcc                            !II         II####!   \/\!#
#!      !####II         II!                           /\o!co\\                            <<      #/\|     \\/\\/###\/\\/\      |/\#      >>                            /\oc!o/\                           !II         II####!      !#
#!  \/  !###!                                        /\ o!o  \\                            <<     #\/        \\/      \/\        \/#     >>                            /\  o!o /\                                        !###!  /\  !#
#!      !###!                                       !/   ! \/ \!                            <<    #                                #    >>                            !/ \/ !   \!                                       !###!      !#
#!  \/\ !###!                                       ! \  !     !                             /^^^^#                                #^^^^\                             !     !  / !                                       !###! \/\  !#
#!/\    !###!                                       !\   !  /\/!                             <    #               ##               #    >                             !\/\  !   /!                                       !###!    \/!#
#!  /   !###!             >                          \\ /!\  \/       /---\                  <    #       \       ##       /       #    >                  /---\       \/  /!\ /\                          <             !###!   /  !#
#!==--==!###!             >                           \\ /\ \/        l~~~l   /\             <          \\/\      ##      /\\/          >             /\   l~~~l        \/ /\ /\                           <             !###!==--==!#
#!      !###!           3 >   5                        ------         lREDl  /T/\            <           /\/\     ##     /\\/           >            /\T\  lBLUl         ------                        6   < 3           !###!      !#
!                         >                                           l~~~l /TTT/\           \v   #      \/\      ##      /\\      #   v/           /\TTT\ l~~~l                                           <                         !
!                         >                                           l~~~l!\TTTT/\ 3          <  #               ##               #  >          3 /\TTTT/!l~~~l                                           <                         !
!                                                                      -#- !R\TTTT/\           <  #               ##               #  >           /\TTTT/U! -#-                                                                      !
#!      !###!                                          /^^^^^^^^^^^^^^^^^^/\ E\TT/T!           <  #             /\##/\             #  >           !T\TT/L /\^^^^^^^^^^^^^^^^^^\                                          !###!      !#
#!      !###!                                   /^^^^^^<                   /\ D\/TT!           <  #             \/##\/             #  >           !TT\/B /\                   >^^^^^^\                                   !###!      !#
#!      !###!             !                     <      <                    /\  !TT/              #####       ##########       #####              \TT!  /\                    >      >                     !             !###!      !#
#!      !###!             !                     <      <                     /\ !T/                                                                \T! /\                     >      >                     !             !###!      !#
###77777#####II         II##############====#################=^^=####         /\!/                                                                  \!/\         ####=^^=#################====##############II         II#####88888###
#}         {#II         II#~~~~~~~~~~~~~~~~~~~~~~~~#                #          /\                                                                    /\          #                #~~~~~~~~~~~~~~~~~~~~~~~~#II         II#}         {#
#}1  1 1  1{#II         II#~~~~~~~~~~~~~~~~~~~~~~~~#                #\          ^^^^                                                              ^^^^          /#                #~~~~~~~~~~~~~~~~~~~~~~~~#II         II#}2  2 2  2{#
#}           I          II#~~~~~~~~~~~~~~~~~~~~~~~~#                ##\                                                                                        /##                #~~~~~~~~~~~~~~~~~~~~~~~~#II          I           {#
#}1  1 1  1  7          II#~~~~~~~~~~~~~~~~~~~~~~~~#                ###\                                                                                      /###                #~~~~~~~~~~~~~~~~~~~~~~~~#II          8  2  2 2  2{#
#}           7          II#~~~~~~~~~~~~~~~~~~~~~~~~#                #####----#----##                          l^^^^^^^^l                          ##----#----#####                #~~~~~~~~~~~~~~~~~~~~~~~~#II          8           {#
#}9  1 1  1  7          II#~~~~~~~~~~~~~~~~~~~~~~~~#                #              #                          l        l                          #              #                #~~~~~~~~~~~~~~~~~~~~~~~~#II          8  2  2 2  9{#
#}           I          II#~~~~~~~~~~~~~~~~~~~~~~~~#                #              #                         /\        /\                         #              #                #~~~~~~~~~~~~~~~~~~~~~~~~#II          I           {#
#}1  1 1  1{#II         II#~~~~~~~~~~~~~~~~~~~~~~~~!                #              #                        /\          /\                        #              #                !~~~~~~~~~~~~~~~~~~~~~~~~#II         II#}2  2 2  2{#
#############II         II#~~~~~~~~~~~~~~~~~~~~~~~~! 3                                                     /\            /\                                                     3 !~~~~~~~~~~~~~~~~~~~~~~~~#II         II#############
 /     \/   #II         II#~~~~~##--##~~~~~~~~~~~~~#                                                      /\              /\                                                      #~~~~~~~~~~~~~##--##~~~~~#II         II# /     \/   
   \    /   #II         II#######    ###############vvv#            #              #                      l                l                      #              #            #vvv###############    #######II         II#   \    /   
    /\      #II                                        <            #              #           3          l^^^^^^^^^^^^^^^^l          3           #              #            >                                        II#    /\      
            #II                                        <            #              #                                                              #              #            >                                        II#        \   
 /  CCo     #II         II###############    #######   <            #######--#######==-----====\                                      /====-----==#######--#######            >   #######    ###############II         II# /  CCo   / 
   ccOco    #II         II#~~~~~~~~~~~~~##--##~~~~~#                #~~~~~~~~~~~~~~# /\  /\    /\                                    /\ /\  /\    #~~~~~~~~~~~~~~#                #~~~~~##--##~~~~~~~~~~~~~#II         II#   ccOco    
    o!cO    #II         II#~~~~~~~~~~~~~~~~~~~~~~~~#                #~~~~~~~~~~~~~~#/   /\/  \/ /\                                  / \/\ \  /\   #~~~~~~~~~~~~~~#                #~~~~~~~~~~~~~~~~~~~~~~~~#II         II#    o!cO /\ 
 /\ O!o     #II         II#~~~~~~~~~~~~~~~~~~~~~~~~#######--#########~~~~~~~~~~~~~~#\/   /\/    \/--    --==================--    --\ \/  \/\ \  /#~~~~~~~~~~~~~~#########--#######~~~~~~~~~~~~~~~~~~~~~~~~#II         II# /\ O!o     
     !      #II---___---II##########################~~~~~~~~~~~~~~~~~~~~~~~~~~~~~~~!   /\  /\  /\/        \/\      /\    /\/        /   /  \/  \ /!~~~~~~~~~~~~~~~~~~~~~~~~~~~~~~~##########################II---___---II#     !      
 \   !                /\          \/\       /\     #~~~~~~~~~~~~~~~~~~~~~~~~~~~~~~~!   \/   /    \        /\  /\  /\   \  /\        \/  \/\  /\  /!~~~~~~~~~~~~~~~~~~~~~~~~~~~~~~~# \                    /\          \/\       !/\    
     !     \/                     \\/         /    #~~~~~~~~~~~~~~~~~~~~~~~~~~~~~~~# /\     \   \/         /  \/\    /\/  \         /\ \/    /\ /\#~~~~~~~~~~~~~~~~~~~~~~~~~~~~~~~#           \/                     \\/       ! / /\ 
    /!\                  \/           \/           #~~~~~~~~~~~~~~~~~~~~~~~~~~~~~~~#/  \/\      /\                                  \/\  /\ \  \ /#~~~~~~~~~~~~~~~~~~~~~~~~~~~~~~~#                         \/           \/   /!\     
 \/\          /\      /                      \/    ################################# /\    /\  /\/==----==\/\/\/\/\/\/\/\/\/==----==/\ \    / \/ \################################# \/\          /\      /                      \/    
[END_DATA]
