ctf_q3dm1.txt

Author: Nuke-m
http://steamcommunity.com/id/EngineMain

A CTF variant of q3dm1.txt.

[SPAWN_RED] 1
[SPAWN_BLU] 2
[MEDKIT] 3
[FLAG_RED] 5
[FLAG_BLU] 6
[SPAWNVIS_RED] 7
[SPAWNVIS_BLU] 8
[RESUPPLY] 9

[DATA]
~~~~~~~~~~~~~~~~~~~~~~~~~~~~~~~~~~~~~~~~~~~~~~~#              #~~~~~~~~~~~~~~~~~~~~~~~##+++++++++++++++++++++++++++++++++++++++++++++++++++++++++++++++++++++++++++++##~~~~~~~~~~~~~~~~~~~~~~~#              #~~~~~~~~~~~~~~~~~~~~~~~~~~~~~~~~~~~~~~~~~~~~~~~
~~~~~~~~~~~~~~~~~~~~~~~~~~~~~~~~~~~~~~~~~~~~~~~#              #~~~~~~~~~~~~~~~~~~~~~~~##+++++++++++++++++++++++++++++++++++++++++++++++++++++++++++++++++++++++++++++##~~~~~~~~~~~~~~~~~~~~~~~#              #~~~~~~~~~~~~~~~~~~~~~~~~~~~~~~~~~~~~~~~~~~~~~~~
~~~~~~~~~~~~~~~~~~~~~~~~~~~~~~~~~~~~~~~~~~~~~~~#              #~~~~~~~~~~~~~~~~~~~~~~~##+++++++++++++++++++++++++++++++++++++++++++++++++++++++++++++++++++++++++++++##~~~~~~~~~~~~~~~~~~~~~~~#              #~~~~~~~~~~~~~~~~~~~~~~~~~~~~~~~~~~~~~~~~~~~~~~~
~~~~~~~~~~~~~~~~~~~~~~~~~~~~~~~~~~~~~~~~~~~~~~~#              #~~~~~~~~~~~~~~~~~~~~~~~##+++##################################+++##################################+++##~~~~~~~~~~~~~~~~~~~~~~~#              #~~~~~~~~~~~~~~~~~~~~~~~~~~~~~~~~~~~~~~~~~~~~~~~
~~~~~~~~~~~~~~~~~~~~~~~~~~~~~~~~~~~~~~~~~~~~~~~#              #~~~~~~~~~~~~~~~~~~~~~~~##+++#                                #+++#                                #+++##~~~~~~~~~~~~~~~~~~~~~~~#              #~~~~~~~~~~~~~~~~~~~~~~~~~~~~~~~~~~~~~~~~~~~~~~~
~~~~~~~~~~~~~~~~~~~~~~~~~~~~~#######################--##--##########~~~~~~~~~~~~~~~~~~##++##                                #+++#                                ##++##~~~~~~~~~~~~~~~~~~##########--##--#####~~################~~~~~~~~~~~~~~~~~~~~~~~~~~~~~
~~~~~~~~~~~~~~~~~~~~~~~~~~~~~##/            ####                  \##~~~~~~~~~~~~~~~~~#####/                                #+++#                                \#####~~~~~~~~~~~~~~~~~##/                  #~~#            \##~~~~~~~~~~~~~~~~~~~~~~~~~~~~~
~~~~~~~~~~~~~~~~~~~~~~~~~~~~~#/      3      ####                   \######################/                             3   #+++#   3                             \###################~##/                   ####      3      \#~~~~~~~~~~~~~~~~~~~~~~~~~~~~~
~~~~~~~~~~~~~~~~~~~###########                                      \###            ####                                    #+++#                                    ####            ###/                                      ###########~~~~~~~~~~~~~~~~~~~
~~~~~~~~~~~~~~~~~~~#}  9  {###                                       \## 3          \##/                              #     #+++#     #                              \##/          3 ##/                                       ###}  9  {#~~~~~~~~~~~~~~~~~~~
~~~~~~~~~~~~~~~~~~~# 1 1 1 ###                                        ##                                  ####              #+++#              ####                                  ##                                        ### 2 2 2 #~~~~~~~~~~~~~~~~~~~
~~~~~~~~~~~~~~~~~~~#       ###                                        ##                                  ####              #+++#              ####                                  ##                                        ###       #~~~~~~~~~~~~~~~~~~~
~~~~~~~~~~~~~~~~~~~#         7              ####                      ##                                  ####              ##~##              ####                                  ##                      ####              8         #~~~~~~~~~~~~~~~~~~~
~~~~~~~~~~~~~~~~~~~#         7              ####                      ##                                  ####              \###/              ####                                  ##                      ####              8         #~~~~~~~~~~~~~~~~~~~
~~~~~~~~~~~~~~~~~~~#         7               \##############\         ##                                                                                                             ##         /##############/               8         #~~~~~~~~~~~~~~~~~~~
~~~~~~~~~~~~~~~~~~~#\        7                ####~~~~~~~~###\        ##                                                                                                             ##        /###~~~~~~~~####                8        /#~~~~~~~~~~~~~~~~~~~
~~~~~~~~~~~~~~~~~~~###########                \###~~~~~~~~~###        ##            ####                                                                             ####            ##        ###~~~~~~~~~###/                ###########~~~~~~~~~~~~~~~~~~~
~~~~~~~~~~~~~~~~~~~~~#########                 \###~~~~~~~~~##        ##            #~~#                                                                             #~~#            ##        ##~~~~~~~~~###/                 #########~~~~~~~~~~~~~~~~~~~~~
~~~~~~~~~~~~~~~~~~~~~##/                        \##~~~~~~~~~~#        ##           /#~~#                                                                             #~~#\           ##        #~~~~~~~~~~##/                        \##~~~~~~~~~~~~~~~~~~~~~
~~~~~~~~~~~~~~~~######/                          \#~~~~~~~~~~#        ##          /##~~#                                                                             #~~##\          ##        #~~~~~~~~~~#/                          \######~~~~~~~~~~~~~~~~
~~~~~~~~~~~~~~~##/                                #~~~~~~~~~~###    ####          ##~~~##\                                 /#####\                                 /##~~~##          ####    ###~~~~~~~~~~#                                \##~~~~~~~~~~~~~~~
~~~#############/                                 #~~~~~~~~#####    ####          \######/                                /##+++##\                                \######/          ####    #####~~~~~~~~#                                 \#############~~~
~~~#                                              #~~~~~~~~#/                        XX                                   ##+++++##                                   XX                        \#~~~~~~~~#                                              #~~~
~~~#                                              #~~~~~~~~#                         XX                                   #+++++++#                                   XX                         #~~~~~~~~#                                              #~~~
~~~#    5                                    3    #~~~~~~~~# 3                       XX                    3              #+++++++#              3                    XX                       3 #~~~~~~~~#    3                                    6    #~~~
~~~#                                              #~~~~~~~~#                         XX                                   #+++++++#                                   XX                         #~~~~~~~~#                                              #~~~
~~~#                                              #~~~~~~~~#\                        XX                                   ##+++++##                                   XX                        /#~~~~~~~~#                                              #~~~
~~~#############\                                 #~~~~~~~~#####    ####          /######\                                \##+++##/                                /######\          ####    #####~~~~~~~~#                                 /#############~~~
~~~~~~~~~~~~~~~##\                                #~~~~~~~~~~###    ####          ##~~~##/                                 \#####/                                 \##~~~##          ####    ###~~~~~~~~~~#                                /##~~~~~~~~~~~~~~~
~~~~~~~~~~~~~~~~######\                          /#~~~~~~~~~~#        ##          \##~~#                                                                             #~~##/          ##        #~~~~~~~~~~#\                          /######~~~~~~~~~~~~~~~~
~~~~~~~~~~~~~~~~~~~~~##\                        /##~~~~~~~~~~#        ##           \#~~#                                                                             #~~#/           ##        #~~~~~~~~~~##\                        /##~~~~~~~~~~~~~~~~~~~~~
~~~~~~~~~~~~~~~~~~~~~#########                 /###~~~~~~~~~##        ##            #~~#                                                                             #~~#            ##        ##~~~~~~~~~###\                 #########~~~~~~~~~~~~~~~~~~~~~
~~~~~~~~~~~~~~~~~~~###########                /###~~~~~~~~~###        ##            ####                                                                             ####            ##        ###~~~~~~~~~###\                ###########~~~~~~~~~~~~~~~~~~~
~~~~~~~~~~~~~~~~~~~#/        7                ####~~~~~~~~###/        ##                                                                                                             ##        \###~~~~~~~~####                8        \#~~~~~~~~~~~~~~~~~~~
~~~~~~~~~~~~~~~~~~~#         7               /##############/         ##                                                                                                             ##         \##############\               8         #~~~~~~~~~~~~~~~~~~~
~~~~~~~~~~~~~~~~~~~#         7              ####                      ##                                  ####              /###\              ####                                  ##                      ####              8         #~~~~~~~~~~~~~~~~~~~
~~~~~~~~~~~~~~~~~~~#         7              ####                      ##                                  ####              ##+##              ####                                  ##                      ####              8         #~~~~~~~~~~~~~~~~~~~
~~~~~~~~~~~~~~~~~~~#       ###                                        ##                                  ####              #+++#              ####                                  ##                                        ###       #~~~~~~~~~~~~~~~~~~~
~~~~~~~~~~~~~~~~~~~# 1 1 1 ###                                        ##                                  ####              #+++#              ####                                  ##                                        ### 2 2 2 #~~~~~~~~~~~~~~~~~~~
~~~~~~~~~~~~~~~~~~~#}  9  {###                                       /## 3          /##\                              #     #+++#     #                              /##\          3 ##\                                       ###}  9  {#~~~~~~~~~~~~~~~~~~~
~~~~~~~~~~~~~~~~~~~###########                                      /###            ####                                    #+++#                                    ####            ###\                                      ###########~~~~~~~~~~~~~~~~~~~
~~~~~~~~~~~~~~~~~~~~~~~~~~~~~#\      3      ####                   /######################\                             3   #+++#   3                             /###################~##\                   ####      3      /#~~~~~~~~~~~~~~~~~~~~~~~~~~~~~
~~~~~~~~~~~~~~~~~~~~~~~~~~~~~##\            ####                  /##~~~~~~~~~~~~~~~~~#####\                                #+++#                                /#####~~~~~~~~~~~~~~~~~##\                  ####            /##~~~~~~~~~~~~~~~~~~~~~~~~~~~~~
~~~~~~~~~~~~~~~~~~~~~~~~~~~~~#######################--##--##########~~~~~~~~~~~~~~~~~~##++##                                #+++#                                ##++##~~~~~~~~~~~~~~~~~~##########--##--#######################~~~~~~~~~~~~~~~~~~~~~~~~~~~~~
~~~~~~~~~~~~~~~~~~~~~~~~~~~~~~~~~~~~~~~~~~~~~~~#              #~~~~~~~~~~~~~~~~~~~~~~~##+++#                                #+++#                                #+++##~~~~~~~~~~~~~~~~~~~~~~~#              #~~~~~~~~~~~~~~~~~~~~~~~~~~~~~~~~~~~~~~~~~~~~~~~
~~~~~~~~~~~~~~~~~~~~~~~~~~~~~~~~~~~~~~~~~~~~~~~#              #~~~~~~~~~~~~~~~~~~~~~~~##+++##################################+++##################################+++##~~~~~~~~~~~~~~~~~~~~~~~#              #~~~~~~~~~~~~~~~~~~~~~~~~~~~~~~~~~~~~~~~~~~~~~~~
~~~~~~~~~~~~~~~~~~~~~~~~~~~~~~~~~~~~~~~~~~~~~~~#              #~~~~~~~~~~~~~~~~~~~~~~~##+++++++++++++++++++++++++++++++++++++++++++++++++++++++++++++++++++++++++++++##~~~~~~~~~~~~~~~~~~~~~~~#              #~~~~~~~~~~~~~~~~~~~~~~~~~~~~~~~~~~~~~~~~~~~~~~~
~~~~~~~~~~~~~~~~~~~~~~~~~~~~~~~~~~~~~~~~~~~~~~~#              #~~~~~~~~~~~~~~~~~~~~~~~##+++++++++++++++++++++++++++++++++++++++++++++++++++++++++++++++++++++++++++++##~~~~~~~~~~~~~~~~~~~~~~~#              #~~~~~~~~~~~~~~~~~~~~~~~~~~~~~~~~~~~~~~~~~~~~~~~
~~~~~~~~~~~~~~~~~~~~~~~~~~~~~~~~~~~~~~~~~~~~~~~#              #~~~~~~~~~~~~~~~~~~~~~~~##+++++++++++++++++++++++++++++++++++++++++++++++++++++++++++++++++++++++++++++##~~~~~~~~~~~~~~~~~~~~~~~#              #~~~~~~~~~~~~~~~~~~~~~~~~~~~~~~~~~~~~~~~~~~~~~~~
[END_DATA]
